20 20
7 6 3 6 10 2 10 10 10 3 6 10 11 6 3 6 2 11 6 3 
12 9 5 13 6 9 6 3 14 1 4 3 6 9 12 9 12 10 9 5 
10 3 12 3 12 10 9 4 3 5 13 4 9 6 3 6 10 10 3 5 
6 8 3 12 3 6 3 5 5 12 3 5 6 9 5 4 11 6 1 5 
5 7 5 7 12 9 5 5 12 3 5 12 9 7 5 13 6 9 13 5 
5 5 12 1 14 3 5 4 11 5 12 3 6 1 12 10 1 6 3 5 
5 4 11 12 10 1 5 13 6 9 6 9 5 12 10 10 9 5 12 9 
5 12 10 10 3 5 12 3 5 7 5 6 9 6 3 6 10 9 6 3 
12 10 3 6 9 4 11 5 5 5 5 5 6 9 5 12 10 10 9 5 
6 10 9 4 10 9 6 9 5 12 1 13 5 7 12 10 10 10 10 1 
5 6 3 13 6 10 9 6 8 3 12 10 9 4 10 10 10 3 6 9 
4 9 12 3 12 3 6 9 7 12 10 10 3 13 6 10 3 5 12 3 
5 14 3 12 10 9 5 7 4 10 10 11 5 6 9 14 8 1 6 9 
12 3 4 2 11 6 8 8 1 6 10 3 5 5 6 10 3 13 12 3 
6 9 13 5 6 9 6 3 13 5 14 8 9 4 9 7 12 3 6 9 
12 10 3 12 8 3 5 12 3 12 10 3 14 8 10 8 3 5 12 3 
6 11 12 10 3 5 5 7 5 6 3 4 10 10 10 3 5 4 11 5 
5 6 3 6 9 13 5 5 12 9 5 5 6 10 10 9 5 12 3 4 
4 9 5 12 10 10 9 4 2 11 5 13 5 6 10 10 9 7 12 9 
12 11 12 10 10 10 10 9 12 10 8 10 9 12 10 10 10 8 10 11 
